111111111111111111111111111111111111111111111111111111111111
122222222211222222222222211222222111112292222222222211111111
122222222221222222222822221222222221222222222222282221111111
122222222222222222222222222222222222222222222222222222211111
111222262222222222222222222222222222222222222222222222221111
111112222222222222222222222222222222222222222222222222221111
111112222222222222222222222222222222222222222222222222222221
122222222222922222222222222222222222222222222222222222222221
122222222222222222222222222222222222222222222222222922222221
122222222222222222222222222222222222222222222222222222222221
111222222222222222222222222222222222222222222222222222222111
111112222222222222222222222222222222222222822222222222221111
111112222222222222222222222222222222222222222222222222222211
111222262222222222222222222222222222222222222222222222222221
112222222212222222222222222222212222222222222222222222222221
122222211112222222922222222222211222222222211222222222622221
111111111111111111111111111111111111111111111111111111111111