111111111111111111111111111111111111111111111111111111111111111
144444444411444444444444411444444444111114444444444444511111111
144444444441444444444444441444444444441444444444444444441111111
144444444444444444444444444444444444444444444444444444444411111
111444444444444444444444444444444444444444444444444444444441111
111114444444444444444444444444444444444444444444444444444441111
111114444444444444444444444444444444444444444444444444444444441
144444444444444444444444444444444444444444444444444444444444441
144444444444444444444444444444444444444444444444444444444444441
144444444444444444444444444444444444444444444444444444444444441
144444444444444444444444444444444444444444444444444444444444111
144444444444444444444444444444444444444444444444444444444444411
144444444444444444444444444444444444444444444444444444444444411
144444444444444444444444444444444444444444444444444444444444441
144444444444444444444444444444444444444444444444444444444444441
144444444444444444444444444444444444444444444444444444444444441
111444444444444444444444444444444444444444444444444444444444111
111114444444444444444444444444444444444444444444444444444441111
111114444444444444444444444444444444444444444444444444444444411
111444444444444444444444444444444444444444444444444444444444441
114444444444414444444444444444444414444444444444444444444444441
144444444411114444444444444444444411444444444411444444444444441
111111111111111111111111111111111111111111111111111111111111111