111111111111111111111111111111111111111111111111111111111111111111
144444444411400000000044411400000000111114444444444444444511111111
144444444441400000000044401400000000001400000000000000000001111111
144444444444444444444444444444444444444444444444444444444444011111
111444444444444444444444444444444444444444444444444444444444001111
111114444444444444444444444444444444444444444444444444444444001111
111114444444444444444444444444444444444444444444444444444444444001
144444444444444444444444444444444444444444444444444444444444444001
144444444444444444444444444444444444444444444444444444444444444001
144444444444444444444444444444444444444444444444444444444444444001
144444444444444444444444444444444444444444444444444444444444444111
144444444444444444444444444444444444444444444444444444444444444011
144444444444444444444444444444444444444444444444444444444444444011
144444444444444444444444444444444444444444444444444444444444444001
144444444444444444444444444444444444444444444444444444444444444001
144444444444444444444444444444444444444444444444444444444444444001
111444444444444444444444444444444444444444444444444444444444444111
111114444444444444444444444444444444444444444444444444444444441111
111114444444444444444444444444444444444444444444444444444444444011
111444444444444444444444444444444444444444444444444444444444444001
114444444444414444444444444444444444414444444444444444444444444001
144444444411114444444444444444444444411444444444411444444444444001
111111111111111111111111111111111111111111111111111111111111111111