111111111111111111111111111111111111111111111111111111111111111111
122222222211222222222222111222222222111112222222222222222511111111
122222222221222222222222212222222222221222222222222222222221111111
122222222222222222222222222222222222222222222222222222222222211111
111222222222222222222222222222222222222222222222222222222222221111
111112222222222222222222222222222222222222222222222222222222221111
111122222222222222222222222222222222222222222222222222222222222221
122222222222222222222222222222222222222222222222222222222222222221
122222222222222222222222222222222222222222222222222222222222222221
122222222222222222222222222222222222222222222222222222222222222221
122222222222222222222222222222222222222222222222222222222222222111
112222222222222222222222222222222222222222222222222222222222222111
111222222222222222222222222222222222222222222222222222222222222111
111112222222222222222222222222222222222222222222222222222222222211
111122222222222222222222222222222222222222222222222222222222222221
111222222222222222222222222222222222222222222222222222222222222221
122222222222222222222222222222222222222222222222222222222222222111
122222222222222222222222222222222222222222222222224222222222222211
122222222222222222222222222222222222222222222222222222222222222211
122222222222222222222222222222222222222222222222222222222222222221
122222222222222222222222222222222222222222222222222222222222222221
122222222222222222222222222222222222222222222222222222222222222221
111222222222222222222222222222222222222222222222222222222222222111
111122222222222222222222222222222222222222222222222222222222221111
111122222222222222222222222222222222222222222222222222222222222211
111222222222222222222222222222222222222222222222222222222222222221
112222222222212222222222222222222212222222222222222222222222222221
122222222211112222222222222222222211222222222211222222222222222221
111111111111111111111111111111111111111111111111111111111111111111