111111111111111111111111111111111111111111111111111111111111111111
100000000011000000000000111000000000111110000000000000000011111111
100000000001000000000000010000000000001000000000000000000001111111
100000000000000000000000000000000000000000000000000000000000011111
111000000000000000000000000000000000000000000000000000000000001111
111110000000000000000000000000000000000000000000000000000000001111
111100000000000000000000000000000000000000000000000000000000000001
100000000000000000000000000000000000000000000000000000000000000001
100000000000000000000000000000000000000000000000000000000000000001
100000000000000000000000000000000000000000000000000000000000000001
100000000000000000000000000000000000000000000000000000000000000111
110000000000000000000000000000000000000000000000000000000000000111
111000000000000000000000000000000000000000000000000000000000000111
111110000000000000000000000000000000000000000000000000000000000011
111100000000000000000000000000000000000000000000000000000000000001
111000000000000000000000000000000000000000000000000000000000000001
100000000000000000000000000000000000000000000000000000000000000111
100000000000000000000000000000000000000000000000000000000000000011
100000000000000000000000000000000000000000000000000000000000000011
100000000000000000000000000000000000000000000000000000000000000001
100000000000000000000000000000000000000000000000000000000000000001
100000000000000000000000000000000000000000000000000000000000000001
111000000000000000000000000000000000000000000000000000000000000111
111100000000000000000000000000000000000000000000000000000000001111
111100000000000000000000000000000000000000000000000000000000000011
111000000000000000000000000000000000000000000000000000000000000001
110000000000010000000000000000000010000000000000000000000000000001
100000000011110000000000000000000011000000000011000000000000000041
111111111111111111111111111111111111111111111111111111111111111111