111111111111111111111111111111111111111111111111111111111111111111
155555555555555555555555555555555555555555555555555555555555555551
155555555555555555555555555555555555555555555555555555555555555551
155555555555555555555555555555555555555555555555555555555555555551
155555555555555555555555555555555555555555555555555555555555555551
155555555555555555555555555555555555555555555555555555555555555551
155555555555555555555555555555555555555555555555555555555555555551
155555555555555555555555555555555555555555555555555555555555555551
155555555555555555555555555555555555555555555555555555555555555551
155555555555555555555555555555555555555555555555555555555555555551
155555555555555555555555555555555555555555555555555555555555555551
155555555555555555555555555555555555555555555555555555555555555551
155555555555555555555555555555555555555555555555555555555555555551
155555555555555555555555555555555555555555555555555555555555555551
155555555555555555555555555555555555555555555555555555555555555551
155555555555555555555555555555555555555555555555555555555555555551
155555555555555555555555555555555555555555555555555555555555555551
155555555555555555555555555555555555555555555555555555555555555551
155555555555555555555555555555555555555555555555555555555555555551
155555555555555555555555555555555555555555555555555555555555555551
155555555555555555555555555555555555555555555555555555555555555551
155555555555555555555555555555555555555555555555555555555555555551
155555555555555555555555555555555555555555555555555555555555555551
155555555555555555555555555555555555555555555555555555555555555551
155555555555555555555555555555555555555555555555555555555555555551
155555555555555555555555555555555555555555555555555555555555555551
155555555555555555555555555555555555555555555555555555555555555541
111111111111111111111111111111111111111111111111111111111111111111